Date,BEDCAP_ICU,VENTCAP_ICU,BEDCAP_OTHER,VENTCAP_OTHER,COVID_NEWICU,COVID_ICU,COVID_NEWOTHER,COVID_OTHER,COVID_VENT,VENTCAP_TOTAL,NONCOVID_ICU,NONCOVID_OTHER,NONCOVID_VENT,COVID_HOSP
2020-04-01,4113,2058,45999,536,5,193,86,327,127,2594,169,6540,106,520
2020-04-02,4977,2089,55950,557,3,415,140,734,295,2646,389,12463,0,1149
2020-04-03,4977,2089,55843,557,5,422,82,798,314,2646,384,12369,0,1220
2020-04-04,4977,2089,56208,557,3,455,54,869,328,2646,1,6541,0,1324
2020-04-05,4977,2089,56548,557,4,488,52,879,340,2646,0,6514,0,1367
2020-04-06,4977,2089,56555,557,2,505,45,906,377,2646,368,12324,0,1411
2020-04-07,5049,2089,56576,557,2,527,53,965,396,2646,391,12312,0,1492
2020-04-08,5063,2741,57319,615,0,554,70,1025,426,3356,548,12449,90,1579
2020-04-09,5063,3581,57260,615,2,544,54,1110,438,4196,1426,23405,417,1654
2020-04-10,5063,3581,57028,615,1,498,52,1218,380,4196,1415,23372,404,1716
2020-04-11,5103,3581,57664,615,0,509,31,1266,367,4196,1033,17551,379,1775
2020-04-12,5103,3581,57536,615,0,519,37,1313,382,4196,1030,17673,380,1832
2020-04-13,5103,3581,57533,615,1,500,52,1411,374,4196,1510,24941,396,1911
2020-04-14,5104,3582,57738,617,3,529,37,1426,377,4199,1510,25359,395,1955
2020-04-15,5372,3879,59426,575,2,522,46,1517,382,4454,1681,26036,508,2039
2020-04-16,6556,3883,59954,575,5,527,41,1547,373,4458,1448,27944,454,2074
2020-04-17,6556,3883,59530,575,1,525,72,1614,365,4458,1388,25589,448,2139
2020-04-18,6552,3891,59337,575,2,515,17,1635,363,4466,1368,25819,386,2150
2020-04-19,6552,3876,59367,575,3,534,24,1737,366,4451,1231,21453,424,2271
2020-04-20,6552,3856,59924,621,3,530,30,1813,364,4477,1466,26873,457,2343
2020-04-21,6552,3856,59952,621,1,524,38,1882,362,4477,1587,28912,480,2406
2020-04-22,6570,3856,59638,582,2,516,27,2044,352,4438,1667,26864,527,2560
2020-04-23,6570,3856,59543,582,3,541,65,2091,379,4438,1612,28750,496,2632
2020-04-24,6567,3855,59611,582,0,525,21,2164,380,4437,1524,26726,446,2689
2020-04-25,6567,3855,59707,582,0,525,30,2183,374,4437,1525,27013,428,2708
2020-04-26,6567,3855,59205,582,0,519,26,2226,372,4437,1325,22060,433,2745
2020-04-27,6567,3855,59219,582,2,520,68,2335,374,4437,1579,27377,478,2855
2020-04-28,6566,3854,59710,582,3,525,33,2374,367,4436,1683,29626,507,2899
2020-04-29,6651,3939,62276,590,1,510,33,2444,355,4529,1750,27989,570,2954
2020-04-30,6651,3939,62278,590,0,502,47,2441,350,4529,1620,29814,491,2943
2020-05-01,6651,3939,61728,590,0,497,37,2481,326,4529,1618,27470,467,2978
2020-05-02,6651,3939,61508,590,1,498,20,2493,345,4529,1633,27408,439,2991
2020-05-03,6651,3939,62140,590,1,491,28,2573,340,4529,1323,21563,424,3064
2020-05-04,6651,3939,62377,590,3,490,16,2611,332,4529,1758,30477,477,3101
2020-05-05,6651,3939,62466,590,1,482,28,2638,339,4529,1689,28723,472,3120
2020-05-06,6648,3936,62564,606,2,489,26,2614,321,4542,1814,29296,547,3103
2020-05-07,6651,3939,62693,659,1,466,18,2621,327,4598,1711,30897,444,3087
2020-05-08,6649,3937,62145,661,1,452,13,2587,308,4598,1618,28617,421,3039
2020-05-09,6649,3937,62506,661,2,440,14,2649,285,4598,1646,28640,391,3089
2020-05-10,6649,3937,62567,661,1,429,14,2660,289,4598,1313,22349,417,3089
2020-05-11,6649,3937,62734,661,0,417,18,2667,284,4598,1966,31322,548,3084
2020-05-12,6649,3937,61953,681,4,420,18,2701,288,4618,1722,29157,462,3121
2020-05-13,6651,3939,62758,679,0,408,20,2628,290,4618,1757,29784,448,3036
2020-05-14,6654,3939,62576,683,2,401,30,2663,280,4622,1968,29931,546,3064
2020-05-15,6654,3939,62386,683,0,395,12,2616,269,4622,1756,29192,445,3011
2020-05-16,6654,3939,62502,683,0,381,12,2621,260,4622,1699,28881,424,3002
2020-05-17,5947,3939,52111,683,0,368,22,2582,248,4622,1357,22394,421,2950
2020-05-18,6654,3939,62232,683,1,374,24,2654,250,4622,1711,29374,436,3028
2020-05-19,6654,3939,62628,683,2,371,20,2405,246,4622,1856,32022,504,2776
2020-05-20,6654,3939,62565,683,6,355,32,2354,235,4622,1995,30564,574,2709
2020-05-21,6642,3939,62541,683,2,346,30,2288,235,4622,1872,32615,466,2634
2020-05-22,6642,3939,61998,683,1,336,26,2231,230,4622,1786,29968,468,2567
2020-05-23,6642,3939,61776,683,0,340,15,2185,215,4622,1823,29662,423,2525
2020-05-24,5947,3939,51545,683,2,340,38,2143,223,4622,1453,23190,403,2483
2020-05-25,6583,3880,62721,758,3,344,19,2180,224,4638,2112,33082,598,2524
2020-05-26,6583,3880,62656,758,0,350,32,2123,229,4638,1844,31360,488,2473
2020-05-27,6583,3880,62757,758,0,332,42,2089,207,4638,1905,31693,496,2421
2020-05-28,6583,3880,62748,758,1,319,15,2004,206,4638,1987,33547,502,2323
2020-05-29,6583,3880,62359,758,3,304,19,1949,187,4638,1868,30938,470,2253
2020-05-30,6583,3880,62778,758,2,304,31,1935,201,4638,1797,31195,440,2239
2020-05-31,6583,3880,62785,758,0,302,37,1942,197,4638,1437,24242,419,2244
2020-06-01,6583,3880,62647,758,1,300,17,1917,186,4638,2163,33635,589,2217
2020-06-02,6583,3880,62792,758,3,301,17,1870,193,4638,1925,32003,497,2171
2020-06-03,6583,3880,62701,758,2,284,37,1804,182,4638,1903,31880,477,2088
2020-06-04,6583,3880,62678,758,2,265,23,1674,179,4638,1913,31993,487,1939
2020-06-05,6583,3880,62801,758,0,261,18,1584,179,4638,1907,31490,501,1845
2020-06-06,6583,3880,62787,758,1,262,13,1541,179,4638,1498,23898,442,1803
2020-06-07,6583,3880,62736,758,1,252,12,1555,163,4638,1478,24199,432,1807
2020-06-08,6433,3730,62891,908,4,249,15,1522,165,4638,2192,34006,595,1771
2020-06-09,6433,3730,61710,908,0,252,13,1420,160,4638,1951,31521,523,1672
2020-06-10,6433,3730,62884,908,0,249,11,1363,156,4638,1971,32527,517,1612
2020-06-11,6433,3730,62879,908,0,237,23,1313,149,4638,2001,34305,528,1550
2020-06-12,6433,3730,62636,908,0,227,6,1220,129,4638,1902,31676,459,1447
2020-06-13,6433,3730,62869,908,0,203,4,1193,135,4638,1867,31636,446,1396
2020-06-14,5738,3730,52344,908,0,199,9,1173,114,4638,1478,24498,462,1372
2020-06-15,6429,3730,63091,908,0,193,11,1120,119,4638,2200,34512,598,1313
2020-06-16,6429,3730,63103,908,0,182,5,1046,111,4638,1978,32971,533,1228
2020-06-17,6429,3730,62662,908,3,166,29,983,104,4638,2027,32818,531,1149
2020-06-18,6429,3730,62357,908,1,159,25,910,107,4638,2095,34406,549,1069
2020-06-19,6429,3730,62989,908,1,158,13,823,107,4638,1985,32588,533,981
2020-06-20,6429,3730,62993,908,1,166,18,794,101,4638,1580,24986,466,960
2020-06-21,6429,3730,62905,908,2,151,5,806,100,4638,1554,25193,458,957
2020-06-22,6429,3730,65699,908,3,145,10,796,94,4638,2341,37033,667,941
2020-06-23,6429,3730,65680,908,1,142,8,781,85,4638,2125,35395,592,923
2020-06-24,6429,3730,65646,908,1,135,36,750,85,4638,2078,35474,597,885
2020-06-25,6429,3730,65616,908,1,127,17,744,79,4638,2160,37467,595,871
2020-06-26,6429,3730,65733,908,1,114,10,714,68,4638,2043,34864,536,828
2020-06-27,6429,3730,65095,908,2,110,17,715,68,4638,1565,25015,453,825
2020-06-28,6429,3730,65334,908,1,107,15,698,65,4638,1604,25547,473,805
2020-06-29,6429,3730,65286,908,1,95,18,688,61,4638,2411,37566,647,783
2020-06-30,6429,3730,65562,908,1,91,23,622,52,4638,2099,35779,572,713
2020-07-01,6429,3730,65450,908,0,87,19,617,45,4638,1567,25752,441,704
2020-07-02,6429,3730,65559,908,0,87,22,591,48,4638,2146,37649,542,678
2020-07-03,6429,3730,65406,908,5,81,17,576,48,4638,2036,35239,530,657
2020-07-04,6429,3730,65488,908,2,79,12,566,46,4638,1924,33299,420,645
2020-07-05,6429,3730,65521,908,0,73,24,572,43,4638,1624,25785,428,645
2020-07-06,6488,3789,65049,849,7,71,25,530,41,4638,2461,38062,627,601
2020-07-07,6488,3789,65456,849,3,73,19,508,43,4638,2225,36596,555,581
2020-07-08,6488,3789,65441,849,5,68,20,476,36,4638,2180,37844,603,544
2020-07-09,6488,3789,65398,849,0,72,18,492,36,4638,2263,38611,595,564
2020-07-10,6488,3789,65370,849,2,67,14,469,29,4638,2130,35989,561,536
2020-07-11,6488,3789,65356,849,2,66,19,478,30,4638,1989,33828,435,544
2020-07-12,6488,3789,65394,849,3,68,21,483,30,4638,1649,26296,419,551
2020-07-13,6488,3789,65445,849,3,71,27,452,34,4638,2416,38729,528,523
2020-07-14,6488,3789,65453,849,2,65,29,446,35,4638,2188,36927,546,511
2020-07-15,6488,3789,65037,849,5,62,28,445,33,4638,2164,36657,574,507
2020-07-16,6488,3789,65056,849,6,67,31,429,32,4638,2257,38703,563,496
2020-07-17,6488,3789,64278,849,10,65,38,427,32,4638,2145,35503,524,492
2020-07-18,6488,3789,65187,849,1,67,29,441,34,4638,1635,26097,451,508
2020-07-19,6488,3789,65438,849,1,71,20,442,35,4638,1619,26408,410,513
2020-07-20,6488,3789,65378,849,7,72,49,455,42,4638,2403,38863,653,527
2020-07-21,6488,3789,65380,849,3,74,50,472,38,4638,2128,36944,549,546
2020-07-22,6488,3789,65397,849,7,73,52,451,41,4638,2156,36956,524,524
2020-07-23,6488,3789,65142,849,8,67,61,398,42,4638,2221,39041,551,465
2020-07-24,6488,3789,65307,849,9,65,55,377,42,4638,2145,36289,554,442
2020-07-25,6488,3789,65288,849,7,63,37,363,43,4638,1606,26219,405,426
2020-07-26,6488,3789,65216,849,4,62,64,376,40,4638,1609,26614,408,438
2020-07-27,6488,3789,65405,849,11,61,63,362,37,4638,2495,38810,652,423
2020-07-28,6488,3789,65345,849,8,62,59,341,37,4638,2191,37054,518,403
2020-07-29,6488,3789,65345,849,13,71,50,344,37,4638,2216,37030,530,415
2020-07-30,6488,3789,66676,849,4,69,70,313,40,4638,2272,38871,548,382
2020-07-31,6488,3789,65332,849,4,71,84,296,37,4638,2055,34347,455,367
2020-08-01,6488,3789,65185,849,3,74,72,290,39,4638,1606,26032,443,364
2020-08-02,6488,3789,65161,849,7,76,54,287,38,4638,1595,26167,433,363
2020-08-03,6488,3789,64898,849,14,84,58,263,40,4638,1725,28486,451,347
2020-08-04,6488,3789,65017,849,1,84,76,263,44,4638,2383,36736,632,347
2020-08-05,6488,3789,65411,849,9,85,60,245,42,4638,2169,37232,533,330
2020-08-06,6488,3789,65448,849,7,81,57,218,38,4638,2251,39287,545,299
2020-08-07,6488,3789,65326,849,5,77,69,227,36,4638,2157,36584,527,304
2020-08-08,6488,3789,65215,849,4,75,68,224,38,4638,1621,26327,436,299
2020-08-09,6488,3789,65229,849,7,70,54,234,41,4638,1636,26603,411,304
2020-08-10,6512,3813,65456,825,13,67,63,214,35,4638,2510,39229,684,281
2020-08-11,6512,3813,65374,825,5,66,74,204,32,4638,2199,37591,542,270
2020-08-12,6512,3813,65497,825,5,69,62,198,32,4638,2175,37797,542,267
2020-08-13,6512,3813,65320,825,1,67,63,232,30,4638,2213,39086,581,299
2020-08-14,6512,3813,65386,825,5,66,89,201,31,4638,2149,36839,550,267
2020-08-15,6512,3813,65353,825,6,66,61,197,30,4638,1642,26572,450,263
2020-08-16,6512,3813,65004,825,3,61,53,202,30,4638,1663,26560,462,263
2020-08-17,6512,3813,65521,825,9,63,72,196,29,4638,2509,39566,679,259
2020-08-18,6512,3813,65099,827,3,63,76,193,24,4640,2231,37513,567,256
2020-08-19,6512,3813,65260,827,2,62,71,193,23,4640,2217,37691,585,255
2020-08-20,6512,3813,65085,827,4,56,79,190,22,4640,2310,39521,564,246
2020-08-21,6512,3813,65404,827,8,50,61,190,20,4640,2193,37182,520,240
2020-08-22,6512,3813,65043,827,3,45,49,185,20,4640,1642,26444,399,230
2020-08-23,6512,3813,65487,827,5,43,59,183,22,4640,1671,27149,419,226
2020-08-24,6512,3813,65425,857,9,42,75,196,22,4670,2542,39581,692,238
2020-08-25,6512,3813,65459,857,8,45,87,197,21,4670,2254,37980,555,242
2020-08-26,6512,3813,64940,857,5,50,76,211,22,4670,2252,37567,550,261
2020-08-27,6512,3813,65059,857,4,52,83,200,24,4670,1897,31558,581,252
2020-08-28,6512,3813,65320,857,7,52,73,197,16,4670,1781,29049,455,249
2020-08-29,6512,3813,65155,857,4,54,101,190,23,4670,1711,26713,463,244
2020-08-30,6512,3813,65401,857,4,58,72,203,21,4670,1680,27060,463,261
2020-08-31,6512,3813,65406,827,8,60,84,208,17,4640,2468,39562,672,268
2020-09-01,6512,3813,65525,827,9,56,111,213,23,4640,2202,37811,549,269
2020-09-02,6512,3813,65508,827,7,58,91,206,28,4640,2182,37705,556,264
2020-09-03,6512,3813,65418,827,8,55,73,208,25,4640,2270,39599,589,263
2020-09-04,6512,3813,65483,827,3,58,96,190,27,4640,2174,36943,564,248
2020-09-05,5817,3813,54784,827,5,49,70,177,21,4640,1680,26502,443,226
2020-09-06,5817,3813,54966,827,6,50,65,177,21,4640,1679,26623,458,227
2020-09-07,5817,3813,55006,827,11,45,135,181,21,4640,1797,29230,491,226
2020-09-08,6512,3813,65525,827,5,52,110,210,25,4640,2434,37625,713,262
2020-09-09,6512,3813,65536,827,3,52,94,217,26,4640,2277,37930,595,269
2020-09-10,6512,3813,65495,827,5,53,97,217,27,4640,2381,40056,620,270
2020-09-11,6512,3813,65395,827,8,48,99,229,27,4640,2254,37330,592,277
2020-09-12,6512,3813,65388,827,6,54,78,229,29,4640,1707,27106,470,283
2020-09-13,6512,3813,65067,827,6,55,93,225,28,4640,1716,26881,452,280
2020-09-14,6512,3813,65152,826,15,68,119,231,31,4639,2610,39918,692,299
2020-09-15,6512,3813,65523,826,4,74,115,233,34,4639,2292,38414,570,307
2020-09-16,6484,3794,65701,845,9,84,127,236,33,4639,2288,38757,557,320
2020-09-17,6484,3794,65711,845,13,80,129,248,34,4639,2367,40917,607,328
2020-09-18,6484,3794,65643,845,5,82,143,249,35,4639,2253,37988,602,331
2020-09-19,6484,3794,65570,845,4,87,96,254,38,4639,1730,27594,496,341
2020-09-20,6484,3794,65609,845,9,88,100,281,43,4639,1705,27774,498,369
2020-09-21,6484,3794,65609,845,7,86,147,313,46,4639,2577,40329,705,399
2020-09-22,6484,3794,65649,845,8,93,122,327,42,4639,2299,38566,553,420
2020-09-23,6484,3794,65651,845,8,94,120,340,43,4639,2321,38573,604,434
2020-09-24,6484,3794,65492,866,12,100,125,362,45,4660,2378,40933,620,462
2020-09-25,6484,3794,65614,866,3,115,136,382,44,4660,2274,38392,596,497
2020-09-26,6484,3794,65140,866,9,114,134,396,46,4660,1734,27511,438,510
2020-09-27,6484,3794,64954,866,12,110,139,405,48,4660,1731,27508,442,515
2020-09-28,6484,3794,65293,866,8,114,137,448,46,4660,2585,40587,744,562
2020-09-29,6484,3794,65722,866,10,120,136,464,46,4660,2362,39071,585,584
2020-09-30,6484,3794,65643,866,9,125,124,485,47,4660,2260,39286,542,610
2020-10-01,6484,3794,65342,866,20,129,181,479,50,4660,2372,41061,620,608
2020-10-02,6484,3794,65451,866,11,141,119,496,55,4660,2223,38433,581,637
2020-10-03,6484,3794,65419,866,4,147,135,508,57,4660,1697,27746,465,655
2020-10-04,6484,3794,65419,866,6,141,102,557,55,4660,1744,27730,447,698
2020-10-05,6484,3794,65754,866,12,146,199,589,61,4660,2554,40489,699,735
2020-10-06,6484,3794,65436,866,13,143,166,621,62,4660,2280,38411,586,764
2020-10-07,4988,2295,65704,866,12,151,227,670,66,3161,2286,38887,647,821
2020-10-08,4988,2295,65749,866,11,150,145,670,64,3161,2346,40937,631,820
2020-10-09,4988,2295,65391,866,10,160,166,664,70,3161,2085,35571,519,824
2020-10-10,4988,2295,63512,866,12,161,148,651,72,3161,1655,25745,478,812
2020-10-11,4988,2295,64386,866,12,170,140,693,71,3161,1649,26216,464,863
2020-10-12,4988,2295,64199,866,6,186,144,688,76,3161,1761,28415,482,874
2020-10-13,4988,2295,65556,866,26,191,230,740,88,3161,2344,37940,668,931
2020-10-14,4990,2300,65360,866,12,191,164,756,95,3166,2234,38520,596,947
2020-10-15,4990,2300,65582,866,0,198,96,781,98,3166,2320,40770,614,979
2020-10-16,4990,2298,65515,866,3,206,107,754,102,3164,2213,38027,611,960
2020-10-17,4990,2300,65505,866,23,209,265,771,101,3166,1731,27827,473,980
2020-10-18,5033,2337,65413,866,12,209,192,790,100,3203,1742,27925,472,999
2020-10-19,5033,2337,65541,866,10,218,181,808,108,3203,2518,40681,724,1026
2020-10-20,5033,2337,65525,866,21,210,270,828,116,3203,2258,38885,632,1038
2020-10-21,5033,2337,65459,866,11,225,200,809,122,3203,2272,38907,629,1034
2020-10-22,5033,2337,65493,866,4,228,136,828,120,3203,2310,40833,653,1056
2020-10-23,5033,2337,64465,922,5,228,138,841,124,3259,2193,37203,642,1069
2020-10-24,5033,2337,64914,922,26,233,285,870,124,3259,1722,27222,494,1103
2020-10-25,5033,2337,64896,922,12,232,240,889,121,3259,1714,27534,489,1121
2020-10-26,5033,2337,64930,922,16,229,263,922,123,3259,2530,40042,713,1151
2020-10-27,5033,2337,65257,922,24,228,279,952,124,3259,2278,38305,629,1180
2020-10-28,5033,2337,65454,922,21,223,208,943,119,3259,2265,38734,644,1166
2020-10-29,5033,2337,65446,922,20,227,251,969,117,3259,2381,41146,638,1196
2020-10-30,5033,2337,65362,922,11,228,182,968,122,3259,2217,37739,634,1196
2020-10-31,5033,2337,65366,922,13,224,245,990,114,3259,1725,27174,506,1214
2020-11-01,5033,2337,64996,922,22,227,216,1032,112,3259,1769,26997,543,1259
2020-11-02,5019,2323,65026,922,22,229,261,1094,121,3245,2358,39708,655,1323
2020-11-03,5019,2323,64689,922,17,235,313,1114,126,3245,2309,39455,688,1349
2020-11-04,5066,2376,65621,922,21,252,273,1102,131,3298,2301,40252,686,1354
2020-11-05,5066,2376,63977,922,13,242,268,1149,127,3298,2419,41058,656,1391
2020-11-06,5077,2387,65500,922,15,254,261,1131,132,3309,2180,37530,591,1385
2020-11-07,5077,2387,64989,922,12,259,252,1136,130,3309,2112,35340,521,1395
2020-11-08,5091,2401,65477,922,20,271,255,1218,137,3323,1728,27478,507,1489
2020-11-09,5093,2956,65534,1227,18,279,285,1249,135,4183,2389,42256,835,1528
2020-11-10,5172,2960,65986,1227,21,300,297,1323,148,4187,1956,31611,696,1623
2020-11-11,5172,2960,66610,1227,27,320,333,1353,156,4187,2146,36629,688,1673
2020-11-12,5172,2960,66579,1227,18,333,267,1415,172,4187,2344,42458,765,1748
2020-11-13,5176,2974,66332,1227,27,342,261,1429,177,4201,2239,39599,748,1771
2020-11-14,5176,2974,66577,1227,20,363,283,1439,178,4201,2136,37164,547,1802
2020-11-15,5176,2974,66601,1227,23,377,242,1458,180,4201,1759,29065,512,1835
2020-11-16,5188,2986,66405,1227,19,402,240,1532,200,4213,2313,41802,668,1934
2020-11-17,5188,2986,66719,1227,34,403,289,1577,210,4213,2282,40517,790,1980
2020-11-18,5188,2986,66719,1227,23,423,274,1570,217,4213,2264,40146,764,1993
2020-11-19,5188,2987,66531,1227,21,419,269,1540,229,4214,2306,42063,771,1959
2020-11-20,5193,2987,62097,1227,16,420,297,1584,224,4214,2190,36208,691,2004
2020-11-21,5152,2988,62115,1227,16,422,205,1646,225,4215,2096,33921,498,2068
2020-11-22,5194,2988,61694,1227,17,443,208,1661,231,4215,1689,28338,501,2104
2020-11-23,5197,2991,61372,1227,13,450,218,1761,236,4218,2264,38268,692,2211
2020-11-24,5173,3005,58909,1213,11,451,288,1804,239,4218,2195,34441,741,2255
2020-11-25,5175,3009,59311,1213,15,442,262,1845,248,4222,2234,34525,734,2287
2020-11-26,5177,3009,59104,1214,13,455,242,1994,241,4223,2316,36192,779,2449
2020-11-27,5182,3013,59353,1215,20,465,223,2035,232,4228,2155,33730,757,2500
2020-11-28,5183,3014,59215,1215,11,470,158,2073,228,4229,2066,26768,526,2543
2020-11-29,5183,3014,59321,1215,17,487,186,2111,247,4229,1720,26553,567,2598
2020-11-30,5190,3014,59973,1214,9,519,175,2197,254,4228,2252,36130,772,2716
2020-12-01,5189,3013,59507,1214,15,525,189,2253,260,4227,2173,34442,769,2778
2020-12-02,5189,3013,59178,1214,21,544,215,2286,263,4227,2119,33889,757,2830
2020-12-03,5189,3013,59487,1214,10,556,195,2348,262,4227,2189,36161,750,2904
2020-12-04,5242,3047,59631,1225,12,556,182,2409,259,4272,2002,31656,590,2965
2020-12-05,5242,3047,59577,1225,14,562,166,2465,254,4272,1686,26332,539,3027
2020-12-06,5242,3047,59612,1225,14,573,145,2558,267,4272,1671,26318,511,3131
2020-12-07,5242,3047,59517,1225,9,589,151,2605,283,4272,2197,35342,770,3194
2020-12-08,5242,3047,59804,945,11,602,190,2577,266,3992,2151,33898,787,3179
2020-12-09,5242,3047,59532,945,15,606,175,2525,280,3992,2163,33718,775,3131
2020-12-10,5242,3047,59451,945,23,646,165,2582,274,3992,2270,35695,782,3228
2020-12-11,5241,3042,59638,944,14,650,156,2557,300,3986,2143,33065,656,3207
2020-12-12,5241,3042,59226,944,18,659,117,2577,298,3986,2012,30856,528,3236
2020-12-13,5241,3042,59706,944,11,651,151,2692,311,3986,1681,26114,533,3343
2020-12-14,5241,3042,59468,944,15,659,134,2826,322,3986,2236,34946,787,3485
2020-12-15,5241,3042,59613,944,14,681,137,2767,333,3986,2150,33682,740,3448
2020-12-16,5241,3042,59143,944,8,697,140,2771,360,3986,2126,32977,740,3468
2020-12-17,5241,3042,59707,944,10,696,142,2778,354,3986,2221,35126,782,3474
2020-12-18,5241,3053,59781,937,15,703,118,2754,338,3990,2057,30642,656,3457
2020-12-19,5241,3053,59515,937,17,706,102,2799,342,3990,1984,30133,508,3505
2020-12-20,5241,3053,59687,937,12,701,138,2936,341,3990,1639,25149,511,3637
2020-12-21,5241,3053,59731,937,14,701,134,2956,356,3990,2150,33644,719,3657
2020-12-22,5241,3053,59824,937,19,702,115,2924,370,3990,2047,31551,738,3626
2020-12-23,5241,3053,59751,937,9,699,162,2888,364,3990,1978,30443,723,3587
2020-12-24,5241,3056,58864,937,14,694,171,2711,337,3993,1821,27000,608,3405
2020-12-25,5241,3056,59396,937,10,700,136,2844,363,3993,1787,26893,486,3544
2020-12-26,5241,3056,60014,937,9,712,98,3083,370,3993,1826,27838,506,3795
2020-12-27,5241,3056,60095,937,7,735,130,3153,384,3993,1525,23870,519,3888
2020-12-28,5241,3056,59302,937,16,744,116,3281,380,3993,1994,30896,566,4025
2020-12-29,5241,3056,59685,937,15,776,173,3492,378,3993,1987,31349,689,4268
2020-12-30,5241,3056,59388,937,12,793,135,3488,375,3993,2008,31459,689,4281
2020-12-31,5241,3053,59108,936,10,787,145,3431,385,3989,1921,30804,685,4218
2021-01-01,5241,3053,59468,936,10,778,159,3398,386,3989,1833,29432,485,4176
2021-01-02,5241,3053,59513,936,10,793,134,3595,392,3989,1850,29520,489,4388
2021-01-03,5241,3053,59449,936,10,804,120,3712,373,3989,1543,24725,449,4516
2021-01-04,5241,3053,59839,936,12,839,117,3754,430,3989,2071,35557,740,4593
2021-01-05,5241,3053,59945,936,20,852,172,3817,447,3989,2045,34245,728,4669
2021-01-06,5241,3053,60020,936,15,848,115,3813,440,3989,2124,33980,713,4661
2021-01-07,5241,3053,60014,936,8,848,138,3830,449,3989,2157,36153,722,4678
2021-01-08,5241,3047,60008,937,11,860,157,3777,450,3984,1934,31649,652,4637
2021-01-09,5241,3047,59919,937,12,856,126,3832,468,3984,1557,26040,517,4688
2021-01-10,5241,3047,59927,937,11,865,115,3996,471,3984,1588,26109,502,4861
2021-01-11,5241,3047,59981,937,12,881,148,4049,470,3984,2111,35692,732,4930
2021-01-12,5242,3047,59823,937,16,888,150,4032,494,3984,2093,33677,729,4920
2021-01-13,5242,3047,59989,948,14,903,160,4025,500,3995,2069,33602,715,4928
2021-01-14,5242,3047,59910,948,10,894,136,3977,491,3995,2078,33937,700,4871
2021-01-15,5242,3055,59901,951,8,889,156,3889,487,4006,2012,31204,540,4778
2021-01-16,5242,3056,59778,951,12,881,296,3838,492,4007,1938,25638,503,4719
2021-01-17,5242,3056,59940,951,7,878,130,3901,504,4007,1607,26013,528,4779
2021-01-18,5256,3058,59998,951,39,873,151,3874,496,4009,2113,35608,730,4747
2021-01-19,5256,3058,59871,951,7,876,162,3757,498,4009,2023,33728,729,4633
2021-01-20,5256,3058,59990,951,17,860,163,3704,497,4009,2040,33754,701,4564
2021-01-21,5256,3058,59533,951,15,849,196,3623,498,4009,2127,35482,722,4472
2021-01-22,5256,3059,59910,954,21,876,203,3527,505,4013,1952,31454,558,4403
2021-01-23,5257,3059,59766,954,9,873,139,3399,499,4013,1919,26071,521,4272
2021-01-24,5257,3059,59869,954,9,873,134,3413,479,4013,1567,26033,482,4286
2021-01-25,5251,3053,59960,954,10,850,202,3354,497,4007,2089,35486,675,4204
2021-01-26,5250,3053,59738,954,14,855,222,3225,486,4007,2065,33762,696,4080
2021-01-27,5250,3053,59685,954,17,833,189,3166,480,4007,2033,33626,716,3999
2021-01-28,5250,3053,59701,954,15,843,233,3088,479,4007,2034,32842,715,3931
2021-01-29,5256,3064,59709,952,11,812,200,2925,426,4016,1929,31477,522,3737
2021-01-30,5242,3064,59825,952,13,806,168,2896,469,4016,1575,31248,500,3702
2021-01-31,5242,3064,59765,952,14,799,196,2883,466,4016,1551,26169,491,3682
2021-02-01,5246,3065,59420,952,14,771,209,2735,458,4017,2040,33967,641,3506
2021-02-02,5246,3065,59947,952,25,759,231,2805,451,4017,2105,34263,722,3564
2021-02-03,5483,3249,59373,952,15,736,245,2696,430,4201,2111,33553,737,3432
2021-02-04,5483,3249,59511,952,12,727,243,2589,415,4201,2230,36041,720,3316
2021-02-05,5514,3246,59593,955,15,709,234,2473,413,4201,2142,33555,628,3182
2021-02-06,5483,3246,59576,955,15,717,219,2403,414,4201,1660,26124,524,3120
2021-02-07,5510,3275,59762,955,19,712,218,2445,407,4230,1678,26139,487,3157
2021-02-08,5501,3260,59739,955,16,678,259,2370,392,4215,2213,35825,724,3048
2021-02-09,5501,3260,59966,955,14,668,275,2301,388,4215,2135,34297,721,2969
2021-02-10,5501,3260,59894,955,20,644,273,2170,372,4215,2154,34241,722,2814
2021-02-11,5501,3260,59887,955,17,623,251,2084,357,4215,2183,34464,661,2707
2021-02-12,5501,3259,59595,959,14,614,285,2007,359,4218,2072,31655,701,2621
2021-02-13,5501,3259,59658,959,10,601,291,2004,353,4218,1687,31332,573,2605
2021-02-14,5501,3259,59667,959,19,606,339,1997,348,4218,1656,26079,573,2603
2021-02-15,5501,3259,59318,959,14,598,343,1922,349,4218,1803,33569,555,2520
2021-02-16,5501,3259,59819,959,20,606,279,1959,354,4218,2143,34260,744,2565
2021-02-17,5501,3259,59732,959,15,576,287,1891,330,4218,2162,34531,761,2467
2021-02-18,5501,3259,59920,959,15,562,343,1883,320,4218,2272,36694,784,2445
2021-02-19,5501,3260,59919,968,15,543,340,1831,312,4228,2165,34016,751,2374
2021-02-20,5365,3149,59809,968,12,563,295,1786,315,4117,2046,32087,506,2349
2021-02-21,5365,3149,59868,968,11,566,281,1846,317,4117,1666,26610,521,2412
2021-02-22,5365,3149,59953,968,14,567,296,1794,323,4117,2253,36791,734,2361
2021-02-23,5365,3149,59964,1056,10,587,359,1769,318,4205,2231,35039,753,2356
2021-02-24,5365,3149,59938,1056,15,573,304,1715,320,4205,2171,35051,733,2288
2021-02-25,5365,3149,60021,1056,13,570,278,1690,318,4205,2305,37171,799,2260
2021-02-26,5364,3148,59976,1055,9,554,290,1637,306,4203,2107,32510,705,2191
2021-02-27,5364,3148,59358,1055,9,569,302,1634,303,4203,2091,31703,541,2203
2021-02-28,5364,3148,59924,1055,9,564,261,1645,293,4203,1701,26950,543,2209
2021-03-01,5364,3148,60034,1055,14,577,251,1608,308,4203,2197,35101,681,2185
2021-03-02,5364,3148,60056,1055,16,560,272,1592,310,4203,2210,35087,759,2152
2021-03-03,5364,3148,59952,1080,12,558,295,1593,306,4228,2182,34983,777,2151
2021-03-04,5364,3148,60056,1080,13,547,291,1566,305,4228,2290,37059,786,2113
2021-03-05,5364,3148,59956,1078,12,542,275,1556,306,4226,2199,34201,771,2098
2021-03-06,5373,3157,59898,1078,12,534,265,1563,303,4235,2040,32113,548,2097
2021-03-07,5373,3157,59920,1078,12,544,240,1596,306,4235,1660,26820,529,2140
2021-03-08,5373,3157,59991,1078,10,554,238,1521,301,4235,2265,36878,709,2075
2021-03-09,5373,3157,60009,1078,12,551,257,1589,302,4235,2200,35003,740,2140
2021-03-10,5373,3157,59945,1078,13,546,258,1556,307,4235,2224,35089,775,2102
2021-03-11,5373,3157,59935,1078,4,546,230,1571,323,4235,2305,37052,770,2117
2021-03-12,5373,3157,59903,1078,7,537,241,1556,312,4235,2156,34223,731,2093
2021-03-13,5403,3193,59694,1079,7,540,181,1594,320,4272,2039,31885,511,2134
2021-03-14,5403,3193,59580,1079,6,562,166,1651,319,4272,1692,26526,504,2213
2021-03-15,5403,3193,59935,1079,7,555,233,1629,320,4272,2114,35073,701,2184
2021-03-16,5408,3198,59844,1079,20,590,216,1602,315,4277,2143,34722,773,2192
2021-03-17,5408,3198,59869,1079,15,584,190,1637,315,4277,2163,34610,749,2221
2021-03-18,5408,3198,59763,1079,17,588,213,1643,297,4277,2268,36595,790,2231
2021-03-19,5404,3198,59534,1080,17,580,154,1681,319,4278,2139,33540,774,2261
2021-03-20,5404,3198,59796,1080,13,584,172,1716,318,4278,2014,31471,552,2300
2021-03-21,5404,3198,59752,1080,10,591,155,1722,322,4278,1686,26323,525,2313
2021-03-22,5404,3198,59862,1080,4,622,159,1790,337,4278,2229,36601,725,2412
2021-03-23,5404,3198,59931,1080,15,638,152,1777,361,4278,2125,34718,721,2415
2021-03-24,5404,3198,59824,1080,12,639,172,1779,354,4278,2152,34688,702,2418
2021-03-25,5419,3198,59906,1080,7,665,165,1832,362,4278,2287,36833,719,2497
2021-03-26,5419,3198,59636,1083,13,675,182,1807,341,4281,1981,31943,511,2482
2021-03-27,5419,3198,59751,1083,8,675,140,1839,365,4281,1972,31749,496,2514
2021-03-28,5419,3198,59734,1083,9,693,163,1891,382,4281,1614,26638,505,2584
2021-03-29,5419,3198,59873,1083,11,705,147,1946,397,4281,2165,36617,698,2651
2021-03-30,5419,3198,59807,1083,10,712,170,1943,399,4281,2090,34556,702,2655
2021-03-31,5419,3198,59661,1083,15,717,152,1974,390,4281,2067,34380,619,2691
2021-04-01,5419,3198,59555,1083,9,722,123,1984,401,4281,2001,31746,640,2706
2021-04-02,5419,3207,59579,1092,8,754,137,2047,393,4299,1918,31062,513,2801
2021-04-03,5425,3207,59518,1092,10,791,118,2088,399,4299,1891,30885,456,2879
2021-04-04,5425,3207,59528,1092,14,819,124,2142,431,4299,1549,25852,498,2961
2021-04-05,5425,3207,59917,1092,11,859,98,2230,463,4299,2003,35724,560,3089
2021-04-06,5429,3211,60011,1092,12,856,127,2286,476,4303,1992,34060,651,3142
2021-04-07,5430,3212,60002,1092,22,897,119,2308,495,4304,1969,34417,684,3205
2021-04-08,5430,3212,60042,1092,24,919,106,2350,522,4304,2081,36826,675,3269
2021-04-09,5430,3219,59773,1088,14,960,145,2413,561,4307,1871,31801,638,3373
2021-04-10,5411,3200,59216,1088,23,996,117,2539,551,4288,1845,31150,507,3535
2021-04-11,5411,3200,59923,1088,18,1014,145,2654,589,4288,1494,26258,487,3668
2021-04-12,5411,3200,60028,1107,24,1028,128,2750,599,4307,2026,35809,701,3778
2021-04-13,5411,3200,60091,1107,16,1045,144,2838,627,4307,1918,33751,709,3883
2021-04-14,5411,3200,59797,1107,25,1070,140,2852,634,4307,1883,33585,693,3922
2021-04-15,5416,3200,60012,1107,25,1125,119,2913,674,4307,1943,35737,698,4038
2021-04-16,5416,3197,59968,1107,5,1154,111,3042,689,4304,1772,30850,637,4196
2021-04-17,5409,3190,59816,1107,17,1186,106,3103,700,4297,1719,30655,479,4289
2021-04-18,5417,3198,59963,1107,12,1216,116,3190,719,4305,1690,30762,478,4406
2021-04-19,5417,3198,59992,1107,11,1215,115,3205,747,4305,1866,34618,682,4420
2021-04-20,5417,3198,60027,1106,16,1261,112,3257,781,4304,1810,32925,694,4518
2021-04-21,5419,3198,59144,1106,11,1293,107,3207,803,4304,1779,32382,660,4500
2021-04-22,5422,3198,59755,1106,8,1308,100,3177,795,4304,1826,34473,675,4485
2021-04-23,5423,3219,59579,1102,20,1334,117,3124,797,4321,1669,29875,586,4458
2021-04-24,5460,3237,59588,1102,11,1342,114,3180,798,4339,1675,29968,442,4522
2021-04-25,5460,3237,59583,1102,11,1367,99,3195,801,4339,1618,30252,446,4562
2021-04-26,5460,3237,59912,1102,15,1365,107,3181,788,4339,1807,34528,663,4546
2021-04-27,5460,3237,59904,1102,12,1363,107,3153,795,4339,1759,32489,670,4516
2021-04-28,5409,3237,60166,1102,7,1380,65,3047,811,4339,1739,32330,658,4427
2021-04-29,5399,3237,60017,1102,10,1381,64,3001,821,4339,1822,34510,664,4382
2021-04-30,5398,3281,60067,1106,6,1386,65,2949,816,4387,1646,29985,574,4335
2021-05-01,5614,3493,59837,1106,14,1387,69,3000,803,4599,1606,30024,452,4387
2021-05-02,5614,3493,59849,1106,7,1381,49,3058,789,4599,1624,30298,444,4439
2021-05-03,5614,3493,59947,1106,5,1384,55,2946,799,4599,1845,34429,570,4330
2021-05-04,5614,3493,59955,1106,9,1375,107,2851,816,4599,1793,32462,708,4226
2021-05-05,5618,3498,59984,1106,14,1346,125,2819,812,4604,1754,32397,683,4165
2021-05-06,5619,3499,59951,1106,16,1320,98,2725,815,4605,1867,34560,722,4045
2021-05-07,5619,3508,59462,1110,22,1310,98,2648,791,4618,1695,29611,601,3958
2021-05-08,5619,3508,59365,1110,14,1300,107,2639,776,4618,1395,24496,467,3939
2021-05-09,5619,3508,59407,1110,11,1287,104,2709,746,4618,1417,24987,455,3996
2021-05-10,5627,3516,59906,1110,18,1281,95,2594,753,4626,1908,34484,715,3875
2021-05-11,5627,3516,59734,1110,18,1259,85,2632,744,4626,1815,32614,715,3891
2021-05-12,5627,3516,59853,1110,10,1262,87,2564,765,4626,1806,30743,695,3826
2021-05-13,5627,3516,59858,1110,15,1268,95,2543,772,4626,1896,32684,712,3811
2021-05-14,5624,3520,59783,1110,16,1269,82,2350,759,4630,1705,28349,603,3619
2021-05-15,5624,3520,59427,1110,7,1278,49,2361,756,4630,1367,22901,475,3639
2021-05-16,5624,3520,59803,1110,21,1268,78,2430,731,4630,1400,23390,469,3698
2021-05-17,5624,3520,59749,1110,12,1247,77,2314,751,4630,1934,33210,756,3561
2021-05-18,5624,3520,59826,1110,13,1195,83,2278,705,4630,1905,32987,782,3473
2021-05-19,5626,3522,59732,1110,15,1163,95,2230,656,4632,1963,32996,753,3393
2021-05-20,5626,3522,59788,1110,8,1140,75,2137,673,4632,2075,34990,801,3277
2021-05-21,5629,3529,59772,1112,13,1116,75,2144,658,4641,1882,30154,686,3260
2021-05-22,5629,3529,59719,1112,7,1088,91,2035,627,4641,1852,30046,504,3123
2021-05-23,5629,3529,59685,1112,5,1079,64,2076,612,4641,1847,30280,522,3155
2021-05-24,5629,3529,59356,1112,12,1073,65,2017,619,4641,1956,32483,569,3090
2021-05-25,5629,3529,59818,1112,12,1060,78,1944,599,4641,1984,33351,794,3004
2021-05-26,5629,3528,59786,1108,16,1028,69,1892,594,4636,2015,33556,788,2920
2021-05-27,5629,3528,59315,1108,14,1000,93,1782,585,4636,2101,35686,821,2782
2021-05-28,5631,3528,59641,1108,9,960,64,1677,557,4636,1917,30767,719,2637
2021-05-29,5631,3528,60305,1108,5,940,76,1641,533,4636,1486,23829,500,2581
2021-05-30,5631,3528,59274,1108,10,939,52,1588,511,4636,1915,25479,546,2527
2021-05-31,5631,3528,59450,1108,12,896,69,1502,509,4636,2134,35528,790,2398
2021-06-01,5631,3528,59431,1108,10,869,79,1482,518,4636,2070,33474,766,2351
2021-06-02,5631,3528,59383,1108,14,810,70,1414,476,4636,2062,33258,791,2224
2021-06-03,5636,3533,59549,1108,8,771,71,1328,473,4641,2071,33302,788,2099
2021-06-04,5636,3528,59433,1107,9,743,85,1293,464,4635,1990,30670,711,2036
2021-06-05,5636,3528,60872,1107,13,728,59,1297,450,4635,1574,30453,514,2025
2021-06-06,5636,3528,60502,1107,7,710,60,1278,442,4635,1648,33386,539,1988
2021-06-07,5636,3528,59921,1045,11,688,68,1243,403,4573,2062,33617,600,1931
2021-06-08,5636,3528,59819,1045,3,674,52,1177,413,4573,2100,33971,763,1851
2021-06-09,5636,3528,59889,1045,14,656,77,1129,400,4573,2090,34016,748,1785
2021-06-10,5632,3526,59746,1034,10,640,71,1048,394,4560,2177,36067,637,1688
2021-06-11,5631,3529,59590,1035,12,608,57,1006,373,4564,1999,31141,664,1614
2021-06-12,5632,3530,59053,1035,5,609,68,995,368,4565,1941,30492,620,1604
2021-06-13,5632,3530,59027,1035,6,593,55,975,357,4565,1913,30883,629,1568
2021-06-14,5632,3530,59165,1035,10,563,54,981,337,4565,2174,35555,751,1544
2021-06-15,5632,3530,59136,1035,12,542,76,930,327,4565,2109,33803,759,1472
2021-06-16,5632,3530,58779,1035,8,514,94,874,319,4565,2104,33568,701,1388
2021-06-17,5632,3530,58652,1035,12,508,92,816,313,4565,2119,33429,701,1324
2021-06-18,5632,3525,58744,1035,8,491,68,780,315,4560,2069,32712,674,1271
2021-06-19,5632,3525,59156,1035,5,488,68,749,297,4560,1576,30689,419,1237
2021-06-20,5632,3525,59746,1035,4,478,50,777,287,4560,1595,31121,434,1255
2021-06-21,5632,3525,59049,1035,7,471,68,696,282,4560,2102,33758,712,1167
2021-06-22,5632,3525,59297,1035,15,460,88,673,274,4560,2212,36218,720,1133
2021-06-23,5632,3525,59079,1035,6,449,121,638,274,4560,2127,33983,703,1087
2021-06-24,5632,3525,59125,1035,10,420,76,646,274,4560,2133,33927,710,1066
2021-06-25,5632,3525,58708,1035,9,414,82,607,253,4560,2127,33012,510,1021
2021-06-26,5632,3525,58850,1035,8,410,94,594,258,4560,1973,25393,472,1004
2021-06-27,5632,3525,58528,1035,8,396,68,605,246,4560,1973,25485,498,1001
2021-06-28,5632,3525,59080,1035,18,377,80,603,241,4560,2136,33564,730,980
2021-06-29,5632,3525,58922,1035,14,374,105,562,237,4560,2320,36390,771,936
2021-06-30,5632,3525,58420,1035,12,360,79,538,227,4560,2206,33612,771,898
2021-07-01,5632,3525,58571,1035,12,349,87,503,209,4560,1677,25572,517,852
2021-07-02,5632,3525,58601,1035,12,333,86,497,213,4560,1646,25323,515,830
2021-07-03,5630,3523,58657,1035,4,314,67,498,203,4558,1660,25650,495,812
2021-07-04,5630,3523,58364,1035,8,309,79,501,198,4558,1699,25427,481,810
2021-07-05,5630,3523,58669,1039,16,302,105,498,198,4562,2255,34221,771,800
2021-07-06,5630,3523,59053,1039,12,288,102,502,192,4562,2371,36938,792,790
2021-07-07,5634,3525,59112,1050,6,279,97,501,184,4575,2253,34773,766,780
2021-07-08,5634,3525,58982,1050,15,275,97,448,180,4575,2255,34596,749,723
2021-07-09,5634,3529,58305,1059,10,272,91,429,174,4588,2100,31417,665,701
2021-07-10,5634,3529,58188,1059,11,275,106,439,172,4588,2044,31151,494,714
2021-07-11,5634,3529,58943,1059,11,279,86,422,160,4588,2101,31935,506,701
2021-07-12,5634,3529,59112,1059,9,259,92,421,165,4588,2190,34461,696,680
2021-07-13,5634,3529,59663,1059,21,249,92,413,158,4588,2263,35444,728,662
2021-07-14,5634,3529,59706,1059,9,237,101,408,152,4588,2365,37546,749,645
2021-07-15,5634,3529,59647,1059,16,224,101,402,151,4588,2231,35122,733,626
2021-07-16,5634,3528,59469,1065,10,211,84,384,146,4593,2102,32304,652,595
2021-07-17,5634,3528,58661,1065,8,209,82,393,135,4593,1717,31861,507,602
2021-07-18,5634,3528,58769,1065,7,210,80,397,130,4593,1693,31968,501,607
2021-07-19,5634,3528,59232,1065,11,205,105,381,133,4593,2220,34556,740,586
2021-07-20,5634,3528,59652,1065,9,213,97,357,110,4593,2230,35139,705,570
2021-07-21,5634,3528,59662,1065,11,214,98,351,121,4593,2331,37286,743,565
2021-07-22,5634,3528,59410,1065,6,209,93,336,118,4593,2194,34771,614,545
2021-07-23,5634,3523,59079,1062,3,196,74,315,116,4585,2106,31935,686,511
2021-07-24,5634,3523,59269,1062,6,188,73,321,116,4585,2090,32005,508,509
2021-07-25,5634,3523,59499,1062,6,191,72,337,111,4585,2058,32294,521,528
2021-07-26,5462,3366,59737,1062,8,189,86,325,118,4428,2244,34812,752,514
2021-07-27,5462,3366,59738,1062,6,185,77,309,117,4428,2272,35179,775,494
2021-07-28,5462,3370,60046,1069,9,188,123,311,118,4439,2373,37285,754,499
2021-07-29,5462,3370,59679,1069,8,183,93,313,119,4439,2209,34920,748,496
2021-07-30,5462,3370,59518,1069,6,171,79,316,123,4439,2087,31992,657,487
2021-07-31,5462,3370,59593,1069,5,160,71,315,114,4439,2057,31472,524,475
2021-08-01,5462,3370,59609,1069,5,162,78,320,110,4439,2066,31692,517,482
2021-08-02,5462,3370,59460,1069,15,168,112,319,109,4439,2110,32218,517,487
2021-08-03,5462,3370,59237,1069,9,170,76,327,106,4439,2139,32549,587,497
2021-08-04,5463,3371,59400,1069,10,176,81,341,103,4440,2363,37181,788,517
2021-08-05,5463,3371,59326,1069,8,173,85,372,101,4440,2229,34738,778,545
2021-08-06,5463,3371,58497,1069,11,177,94,339,103,4440,2098,31616,723,516
2021-08-07,5463,3371,59486,1069,9,175,94,354,97,4440,1725,26272,534,529
2021-08-08,5463,3371,59234,1069,12,172,80,342,94,4440,1727,26274,531,514
2021-08-09,5463,3366,58950,1070,13,179,90,369,95,4436,2223,34661,769,548
2021-08-10,5463,3366,59898,1070,5,187,82,380,102,4436,2235,35415,786,567
2021-08-11,5463,3366,59384,1070,14,207,70,386,104,4436,2346,37369,829,593
2021-08-12,5463,3366,59614,1070,15,204,96,415,99,4436,2194,35417,810,619
2021-08-13,5463,3365,59538,1067,6,214,78,426,99,4432,2093,32308,730,640
2021-08-14,5463,3365,59587,1067,7,222,78,409,103,4432,1734,26471,570,631
2021-08-15,5463,3365,59774,1067,9,227,96,426,104,4432,1725,26945,551,653
2021-08-16,5463,3365,59282,1067,8,243,114,468,118,4432,2237,35167,810,711
2021-08-17,5463,3365,59473,1067,17,248,125,486,119,4432,2232,35283,831,734
2021-08-18,5463,3365,59779,1067,16,255,122,523,114,4432,2298,37614,808,778
2021-08-19,5460,3365,59809,1067,14,269,104,561,122,4432,2192,35433,782,830
2021-08-20,5460,3373,59339,1066,15,272,86,606,126,4439,2065,32397,728,878
2021-08-21,4732,2682,52607,709,3,225,67,556,99,3391,1695,26676,531,781
2021-08-22,4732,2682,52689,709,11,240,75,601,102,3391,1677,26789,543,841
2021-08-23,4732,2682,52234,709,13,245,66,612,112,3391,1803,29245,638,857
2021-08-24,5460,3373,59517,1066,15,333,105,712,154,4439,2212,35569,783,1045
2021-08-25,5460,3373,59505,1066,24,350,114,740,166,4439,2270,37629,808,1090
2021-08-26,5454,3373,59488,1066,17,365,105,797,157,4439,2193,35146,780,1162
2021-08-27,5454,3368,59193,1045,12,381,87,810,160,4413,2074,32262,715,1191
2021-08-28,5454,3368,58615,1045,11,380,84,819,173,4413,2045,26189,536,1199
2021-08-29,5454,3368,59158,1045,8,394,84,831,170,4413,2046,26972,530,1225
2021-08-30,5454,3368,59514,1045,11,411,110,877,177,4413,2146,34913,694,1288
2021-08-31,5454,3368,59311,1066,13,434,166,905,194,4434,2209,35233,816,1339
2021-09-01,5454,3368,59468,1066,17,449,114,927,213,4434,2258,37534,836,1376
2021-09-02,5454,3368,58921,1066,16,468,138,935,221,4434,2173,34968,781,1403
2021-09-03,5454,3371,59319,1064,15,482,98,1006,222,4435,2009,32384,627,1488
2021-09-04,5454,3371,59197,1064,11,496,92,1040,228,4435,2013,26347,570,1536
2021-09-05,5454,3371,58885,1064,13,516,95,1057,238,4435,1991,26331,554,1573
2021-09-06,5454,3371,59512,1064,19,535,98,1077,241,4435,2017,27235,582,1612
2021-09-07,5454,3371,59065,1064,15,556,99,1151,242,4435,2229,34959,803,1707
2021-09-08,5454,3371,59207,1064,17,569,103,1224,258,4435,2326,37433,923,1793
2021-09-09,5458,3371,59273,1064,11,579,119,1241,263,4435,2202,35513,785,1820
2021-09-10,5458,3372,59389,1065,10,600,89,1312,272,4437,2106,33194,694,1912
2021-09-11,3076,1739,39838,1065,14,451,92,1114,169,2804,535,15464,52,1565
2021-09-12,5458,3372,59492,1065,18,631,95,1351,269,4437,2038,33213,538,1982
2021-09-13,5458,3372,59645,1065,15,657,109,1336,278,4437,2197,35634,715,1993
2021-09-14,5458,3372,59701,1065,17,677,117,1426,292,4437,2292,38313,764,2103
2021-09-15,5458,3372,59615,1065,12,678,124,1441,297,4437,2299,38194,887,2119
2021-09-16,5459,3372,59620,1065,10,684,117,1440,315,4437,2301,37882,818,2124
2021-09-17,5461,3375,59563,1067,13,672,115,1470,298,4442,2178,35258,834,2142
2021-09-18,4733,2682,52644,709,10,523,91,1339,219,3391,1723,27295,549,1862
2021-09-19,4733,2682,52692,709,3,537,63,1364,216,3391,1761,27524,533,1901
2021-09-20,5461,3375,59661,1067,22,708,119,1551,330,4442,2231,37803,886,2259
2021-09-21,5435,3351,59696,1067,11,728,111,1632,330,4418,2233,38040,882,2360
2021-09-22,5435,3351,59239,1067,12,732,127,1658,340,4418,2228,37970,904,2390
2021-09-23,5435,3351,59591,1067,14,743,121,1692,332,4418,2229,37788,667,2435
2021-09-24,5435,3353,59613,1069,13,740,120,1678,329,4422,2056,33085,763,2418
2021-09-25,4707,2658,52383,709,5,594,70,1456,230,3367,1703,27126,535,2050
2021-09-26,4707,2658,52866,709,3,611,73,1490,235,3367,1705,27535,543,2101
2021-09-27,5435,3353,59670,1069,13,751,136,1726,337,4422,2278,37537,861,2477
2021-09-28,5435,3353,59651,1069,17,758,118,1747,328,4422,2292,37860,886,2505
2021-09-29,5435,3353,59582,1069,13,763,144,1722,323,4422,2293,37879,918,2485
2021-09-30,4707,2658,52326,709,13,610,78,1528,235,3367,1969,31655,712,2138
2021-10-01,5435,3352,58266,1069,10,744,110,1714,318,4421,2176,33817,811,2458
2021-10-02,4707,2658,52715,709,9,605,81,1542,231,3367,1836,28916,580,2147
2021-10-03,4707,2658,52361,709,11,603,68,1544,232,3367,1845,28692,574,2147
2021-10-04,5435,3352,59171,1069,19,744,152,1782,323,4421,2296,36721,904,2526
2021-10-05,5435,3352,59602,1069,20,743,133,1806,319,4421,2352,38133,846,2549
2021-10-06,5435,3352,59644,1069,13,726,142,1851,317,4421,2350,38186,937,2577
2021-10-07,5435,3352,59566,1069,19,729,137,1864,312,4421,2323,37768,951,2593
2021-10-08,5435,3345,59358,1069,19,728,165,1827,309,4414,2248,35589,866,2555
2021-10-09,5435,3345,58825,1069,22,716,154,1775,314,4414,1861,28651,598,2491
2021-10-10,5435,3345,58855,1069,20,714,135,1794,310,4414,1835,28564,580,2508
2021-10-11,5435,3345,59579,1069,18,694,176,1805,308,4414,1851,29227,577,2499
2021-10-12,5435,3344,59479,1069,19,718,160,1778,326,4413,2299,37196,978,2496
2021-10-13,5435,3345,59760,1069,19,710,211,1797,331,4414,2365,38692,971,2507
2021-10-14,5435,3345,60167,1069,20,713,185,1754,342,4414,2350,38753,880,2467
2021-10-15,5396,3324,59854,1072,17,705,145,1769,340,4396,2263,36632,787,2474
2021-10-16,5396,3324,60090,1072,13,697,128,1726,331,4396,2217,35743,611,2423
2021-10-17,5396,3324,60057,1072,31,706,331,1740,336,4396,2233,35211,583,2446
2021-10-18,5396,3324,60016,1072,25,703,230,1722,345,4396,2334,37867,837,2425
2021-10-19,5383,3314,60259,1072,36,676,294,1732,348,4386,2393,38530,867,2408
2021-10-20,5383,3314,60017,1072,42,674,311,1668,335,4386,2358,38692,856,2342
2021-10-21,5383,3314,59205,1072,35,639,395,1678,307,4386,2275,35283,845,2317
2021-10-22,5383,3314,59262,1069,30,630,355,1626,310,4383,2129,33731,766,2256
2021-10-23,5383,3314,59238,1069,27,634,291,1580,309,4383,2103,32922,574,2214
2021-10-24,5383,3314,58874,1069,45,626,378,1570,308,4383,2109,32335,572,2196
2021-10-25,5383,3314,59411,1069,36,616,436,1529,294,4383,2321,37042,854,2145
2021-10-26,5383,3314,59871,1069,33,615,429,1491,296,4383,2376,38246,870,2106
2021-10-27,5383,3314,59831,1069,44,613,536,1489,301,4383,2361,38289,863,2102
2021-10-28,5383,3314,60126,1069,45,606,561,1479,291,4383,2371,38539,734,2085
2021-10-29,5383,3315,59677,1069,38,604,548,1448,292,4384,2197,34953,747,2052
2021-10-30,5383,3315,59743,1069,32,590,472,1421,294,4384,2150,28283,546,2011
2021-10-31,5383,3315,59239,1069,23,580,499,1444,283,4384,2120,27937,524,2024
2021-11-01,5383,3315,59788,1071,40,578,622,1436,270,4386,2241,36057,830,2014
2021-11-02,5383,3315,59816,1071,39,563,674,1498,266,4386,2286,37039,831,2061
2021-11-03,5383,3315,58843,1071,44,543,727,1413,274,4386,2275,36210,813,1956
2021-11-04,5383,3315,59758,1071,38,525,706,1411,270,4386,2281,37437,846,1936
2021-11-05,5383,3313,59536,1075,36,516,692,1411,259,4388,2177,34837,739,1927
2021-11-06,5383,3313,59763,1075,35,504,636,1412,252,4388,2179,34216,528,1916
2021-11-07,5383,3313,59452,1075,33,499,561,1425,249,4388,2133,34037,545,1924
2021-11-08,5383,3313,58111,1073,39,496,711,1379,252,4386,2303,35806,769,1875
2021-11-09,5383,3313,59047,1073,38,501,684,1379,259,4386,2332,36734,830,1880
2021-11-10,5383,3313,59787,1073,35,485,707,1295,255,4386,2316,37255,828,1780
2021-11-11,5383,3313,59090,1073,31,469,719,1327,254,4386,2233,34236,561,1796
2021-11-12,5383,3311,58539,1076,37,472,728,1315,247,4387,2206,33562,731,1787
2021-11-13,5383,3311,59480,1076,27,471,645,1316,243,4387,2165,33610,526,1787
2021-11-14,5383,3311,58826,1076,26,476,659,1326,251,4387,2184,32854,527,1802
2021-11-15,5383,3311,59249,1076,39,473,693,1293,239,4387,2271,36120,815,1766
2021-11-16,5383,3311,59799,1076,23,451,732,1322,239,4387,2311,36794,819,1773
2021-11-17,5383,3311,59580,1076,21,447,717,1303,238,4387,2313,36810,788,1750
2021-11-18,5383,3311,59885,1076,27,445,769,1290,241,4387,2292,36820,810,1735
2021-11-19,5382,3304,58839,1072,36,446,689,1265,245,4376,2207,34260,716,1711
2021-11-20,5381,3304,59060,1072,31,445,628,1245,246,4376,2178,34275,555,1690
2021-11-21,5381,3304,59120,1072,14,458,533,1258,243,4376,2162,33419,518,1716
2021-11-22,5381,3304,58794,1072,25,449,574,1250,237,4376,2293,36197,802,1699
2021-11-23,5381,3304,59446,1072,23,460,624,1227,235,4376,2349,37781,817,1687
2021-11-24,5381,3304,58132,1072,22,452,656,1210,223,4376,2340,36691,827,1662
2021-11-25,5381,3304,59267,1072,26,451,656,1133,230,4376,2340,37693,847,1584
2021-11-26,5381,3306,59258,1073,25,446,575,1138,231,4379,2233,35113,762,1584
2021-11-27,5381,3306,58530,1073,18,435,513,1161,230,4379,2092,31943,570,1596
2021-11-28,5381,3306,58562,1073,16,444,469,1151,232,4379,2101,30802,587,1595
2021-11-29,5381,3306,58914,1073,21,470,494,1164,238,4379,2262,36120,827,1634
2021-11-30,5381,3306,58951,1073,18,458,501,1186,229,4379,2408,35456,820,1644
2021-12-01,5381,3306,58888,1073,18,443,509,1182,227,4379,2380,35464,811,1625
2021-12-02,5381,3306,58828,1073,9,435,367,1144,229,4379,2367,37193,796,1579
2021-12-03,5344,3304,58736,1071,11,454,371,1089,232,4375,2305,34938,714,1543
2021-12-04,5344,3304,57818,1071,5,446,261,1093,231,4375,2214,31320,551,1539
2021-12-05,5344,3304,57943,1071,7,457,242,1129,234,4375,2146,29513,514,1586
2021-12-06,5344,3304,59012,1071,6,446,292,1117,229,4375,2400,36951,804,1563
2021-12-07,5344,3304,59677,1071,10,426,342,1123,230,4375,2454,38160,825,1549
2021-12-08,5344,3304,59149,1071,11,430,295,1098,226,4375,2486,37826,851,1528
2021-12-09,5344,3304,59666,1071,5,425,318,1096,220,4375,2489,38190,897,1521
2021-12-10,5344,3307,59512,1069,10,420,275,1092,217,4376,2352,35584,763,1512
2021-12-11,5344,3307,59327,1069,15,424,253,1110,213,4376,2258,32520,533,1534
2021-12-12,5344,3307,59174,1069,8,439,221,1125,208,4376,2250,32139,504,1564
2021-12-13,5344,3307,58518,1069,8,453,229,1086,229,4376,2410,36390,812,1539
2021-12-14,5344,3307,58648,1069,8,453,255,1066,234,4376,2439,37257,848,1519
2021-12-15,5352,3315,58368,1069,14,440,266,1097,238,4384,2452,36931,883,1537
2021-12-16,5352,3315,59080,1069,12,424,75,1126,223,4384,2453,37402,841,1550
2021-12-17,5356,3316,58866,1070,6,435,70,1142,225,4386,2357,34850,748,1577
2021-12-18,5356,3316,58128,1070,48,453,101,1136,238,4386,2223,31047,558,1589
2021-12-19,5356,3316,58381,1070,21,459,153,1199,241,4386,2193,30781,548,1658
2021-12-20,5356,3316,59001,966,21,468,156,1203,241,4282,2329,35039,799,1671
2021-12-21,5358,3318,58705,966,19,463,181,1248,249,4284,2359,34884,821,1711
2021-12-22,5358,3318,58593,966,22,455,190,1340,240,4284,2332,33661,774,1795
2021-12-23,5359,3318,58688,966,22,461,209,1338,246,4284,2242,33669,793,1799
2021-12-24,5359,3318,58538,966,20,451,210,1386,233,4284,2138,31902,787,1837
2021-12-25,5359,3318,58328,966,21,449,266,1435,230,4284,2028,28401,552,1884
2021-12-26,5359,3318,58389,966,12,476,201,1692,231,4284,2087,30867,550,2168
2021-12-27,5359,3318,58417,966,36,490,256,1922,240,4284,2143,31694,591,2412
2021-12-28,5359,3318,59146,966,34,476,252,2156,242,4284,2152,33004,553,2632
2021-12-29,5359,3318,59101,966,35,510,291,2489,247,4284,2202,33375,784,2999
2021-12-30,5360,3319,58304,965,34,533,392,2829,253,4284,2244,33044,780,3362
2021-12-31,5359,3318,57923,966,30,550,337,2789,272,4284,2229,32368,767,3339
2022-01-01,5359,3318,58233,966,26,574,346,3291,272,4284,2159,30142,553,3865
2022-01-02,5359,3318,57884,966,17,619,283,3655,298,4284,2225,32002,565,4274
2022-01-03,5359,3318,58173,966,27,645,297,4113,308,4284,2207,32587,552,4758
2022-01-04,5359,3314,59240,965,27,704,392,4618,336,4279,2272,34272,795,5322
2022-01-05,5360,3315,58714,965,23,739,389,5041,365,4280,2156,33914,816,5780
2022-01-06,5360,3315,58730,965,23,791,384,5340,370,4280,2330,35495,846,6131
2022-01-07,5359,3313,58482,961,19,865,387,5878,402,4274,2270,35321,821,6743
2022-01-08,5359,3313,58947,961,31,903,428,6277,403,4274,2116,32967,551,7180
2022-01-09,5359,3313,58840,961,21,914,348,6537,408,4274,2084,32738,529,7451
2022-01-10,5359,3313,59050,961,21,973,283,7115,428,4274,2174,35205,814,8088
2022-01-11,5359,3313,58851,961,29,1021,385,7530,441,4274,2193,35040,826,8551
2022-01-12,5359,3313,59249,961,25,1029,437,7950,463,4274,2213,35151,813,8979
2022-01-13,5359,3313,58826,961,30,1067,358,8275,477,4274,2187,34394,821,9342
2022-01-14,5359,3314,58692,960,24,1096,416,8525,520,4274,2035,32070,752,9621
2022-01-15,5359,3314,59173,960,21,1121,403,8865,544,4274,1998,32034,535,9986
2022-01-16,5359,3314,59172,960,32,1124,321,9135,560,4274,1961,31764,531,10259
2022-01-17,5359,3314,58636,960,20,1180,302,9408,577,4274,2066,33430,795,10588
2022-01-18,5359,3314,59191,960,17,1200,359,9387,590,4274,2110,34691,747,10587
2022-01-19,5359,3314,59302,960,25,1216,384,9527,589,4274,2111,34457,761,10743
2022-01-20,5359,3314,59233,960,27,1198,413,9523,606,4274,2105,34531,726,10721
2022-01-21,5368,3320,59372,965,31,1214,356,9437,630,4285,2007,32626,698,10651
2022-01-22,5368,3320,59049,965,44,1208,475,9465,624,4285,1999,31640,523,10673
2022-01-23,5368,3320,59220,965,19,1206,303,9630,620,4285,1952,31717,500,10836
2022-01-24,5368,3320,59389,965,21,1233,305,9789,638,4285,2097,34367,750,11022
2022-01-25,5368,3320,59307,965,26,1192,346,9542,643,4285,2125,34869,756,10734
2022-01-26,5373,3320,59126,965,27,1159,336,9395,618,4285,2135,34717,753,10554
2022-01-27,5373,3320,59066,965,13,1169,271,9279,640,4285,2137,34533,776,10448
2022-01-28,5373,3320,59408,964,21,1166,257,8903,636,4284,1991,33127,712,10069
2022-01-29,5373,3320,58517,964,17,1141,258,8770,597,4284,1955,31503,542,9911
2022-01-30,5373,3320,58496,964,18,1139,190,8831,587,4284,1950,31483,486,9970
2022-01-31,5373,3320,59310,964,22,1144,169,8812,596,4284,2058,34499,756,9956
2022-02-01,5373,3320,59297,964,25,1099,254,8609,569,4284,2117,35271,749,9708
2022-02-02,5373,3320,58989,964,16,1073,220,8321,578,4284,2115,35425,778,9394
2022-02-03,5374,3321,58595,964,1,1054,138,8107,550,4285,2061,33074,717,9161
2022-02-04,5374,3318,58638,966,8,1034,105,7781,531,4284,2052,32991,899,8815
2022-02-05,5374,3318,59119,966,3,999,93,7578,522,4284,2087,32796,561,8577
2022-02-06,5374,3318,58684,966,7,1004,108,7574,522,4284,2033,32340,524,8578
2022-02-07,5374,3318,58908,966,1,1007,81,7495,537,4284,2094,33343,927,8502
2022-02-08,5374,3318,58267,966,6,975,80,7312,521,4284,2076,33244,909,
2022-02-09,5374,3318,57982,966,5,956,79,7150,519,4284,2100,33175,729,
2022-02-10,5374,3318,59095,966,8,920,72,6880,490,4284,2065,34175,730,
2022-02-11,5374,3333,58613,967,2,874,68,6618,466,4300,2062,33808,751,
2022-02-12,5374,3333,57774,967,2,846,74,6401,440,4300,2043,32247,546,
2022-02-13,5374,3333,58359,967,3,839,50,6492,429,4300,1965,31526,526,
2022-02-14,5374,3333,59020,967,1,805,56,6348,423,4300,2044,34509,702,